"a" = (/turf/floors/grass,/area)
"b" = (/turf/walls/wall,/area)
"c" = (/turf/floors/grass,/turf/start,/area)
"d" = (/turf/floors/sand,/area)
"e" = (/turf/floors/sand,/turf/trap/quicksand,/area)
"f" = (/turf/trap/quicksand,/area)
"g" = (/obj/ExplorerSword,/turf/floors/grass,/area)
"h" = (/mob/AggroSlime,/turf/floors/grass,/area)

(1,1,1) = {"
dddddddddddddddddddddddddddddddddddddddddddddddddd
dddddddddddddddddddddddddddddddddddddddddddddddddd
dddddddeddddddddddddddddddddddddddddfddddddddddddd
ddddddddddddddddddddddddddddddddddeddddddddddddfdd
dddddddddddddddddddddddddddddddddddddddddddddddddd
dddfdddddddddddddddddddddddddddddddddddddddddddddd
dddddddddddddddddddddddedddddddddddddddddddddddddd
dddddddddddddddddddddddddddddddddddddddddddddddddd
ddddddddddddddddeddddddddddddddddddddddddddddddddd
dddddddddddddddddddddddddddddddddddddfdddddddddddd
dddddddddddddddddddddddddddddddddddddddddddddddddd
ddddddddfddddddddddddddddddddddddddddddddddddddddd
dddddddddddddddddddddddddddddddddddddddddddddddddd
ddddddddddddddddddddaddddddddddddddddddddddddddddd
bbbbbbbbbbbbbbbbbbbaaadabbbbbbbbbbbbbbbbbbbbbbbbbb
aaaaaaaaaaaaaaaaabbbaaabbbaaaaaaaaaaaaaaaaaaaaaaaa
aaaaaaaaaaaaaaaaaaaaadaaaaaaaaaaaaaaaaaaaaaaaaaaaa
aaaaaaaaaaaaaaaaaaaaaaaaaaaaaaaaaaaaaaaaaaaaaaaaaa
aaaaaaaaaaaaaaaaaaaaaadaaaaaaaaaaaaaaaaaaaaaaaaaaa
aaaaaaaaaaaaaaaaaaaaaaaaaaaaaaaaaaaaaaaaaaaaaaaaaa
aaaaaaaaaaaaaaaaaaaaaaaaaaaaaaaaaaagaaaaaaaaaaaaaa
aaaaaaaaaaaaaaaaaaaaaaaaaaaaaaaaaaaaaaaaaaaaaaaaaa
aaaaaaaaaaaaaaaaaaaaaaaaaaaaaaaaaaaaaaaaaaaaaaaaaa
aaaaaaaaaaaaaaaaaaaaaaaaaaaaaaaaaaaaaaaaaaaaaaaaaa
aaaaaaaaaaaaaaaaaaaaaaaaaaaaaaaaaaaaaaaaaaaaaaaaaa
aaaaaaaaaaaaaaaaaaaaaaaaaaaaaaaaaaaaaaaaaaaaaaaaaa
aaaaaaaaaaaaaaaaaaaaaaaaaaaaaaaaaaaaaaaaaaaaaaaaaa
aaaaaaaaaaaaaaaaaaaaaaaaahaaaaaaaaaaaaaaaaaaaaaaaa
aaaaaaaaaaaaaaaaaaaaaaaaaaaaaaaaaaaaaaaaaaaaaaaaaa
aaaaaaaaaaaaaaaaaaaaaahaaaaaaaaaaaaaaaaaaaaaaaaaaa
aaaaaaaaaaaaaaaaaaaaaaaaaaaaaaaaaaaaaaaaaaaaaaaaaa
aaaaaaaaaaaaaaaaaaaaaaaaaahaaaaaaaaaaaaaaaaaaaaaaa
aaaaaaaaaaaaaaaaaaaaaaaaaahaaaaaaaaaaaaaaaaaaaaaaa
aaaaaaaaaaaaaaaaaaaaaaaaaaaaaaaaaaaaaaaaaaaaaaaaaa
aaaaaaaaaaaaaaaaaaaaaaaaaaahaaaaaaaaaaaaaaaaaaaaaa
aaaaaaaaaaaaaaaaaaaaaahaaaaaaaaaaaaaaaaaaaaaaaaaaa
bbbbbbbbbbbbbbbbaaaaaaaaaaaaaaaaaaaaaaaaaaaaaaaaaa
baaaaaaaaaaaaaaaaaaaaaaaaaaaaaaaaaaaaaaaaaaaaaaaaa
baaaaaaaaaaaaaaaaaaaaaaaaaaaaaaaaaaaaaaaaaaaaaaaaa
baaaaaaaaaaaaaabaaaaaaaaaaaaaaaaaaaaaaaaaaaaaaaaaa
baaaaaaaaaaaaaabaaaaaaaaaaaaaaaaaaaaaaaaaaaaaaaaaa
baaaaaaaaaaaaaabaaaaaaaaaaaaaaaaaaaaaaaaaaaaaaaaaa
baaaaabbbbbaabbbaaaaaaaaaaaaaaaaaaaaaaaaaaaaaaaaaa
baaaaabaaaaaaaabaaaaaaaaaaaaaaaaaaaaaaaaaaaaaaaaaa
baaaaabaaaaaaaabaaaaaaaaaaaaaaaaaaaaaaaaaaaaaaaaaa
baaaaaaaaaaaaaabaaaaaaaaaaaaaaaaaaaaaaaaaaaaaaaaaa
baaaaaaaaaaaaaabaaaaaaaaaaaaaaaaaaaaaaaaaaaaaaaaaa
baaaaabaaaaaaaabaaaaaaaaaaaaaaaaaaaaaaaaaaaaaaaaaa
baaaaabaaaaaaacbaaaaaaaaaaaaaaaaaaaaaaaaaaaaaaaaaa
bbbbbbbbbbbbbbbbaaaaaaaaaaaaaaaaaaaaaaaaaaaaaaaaaa
"}
