"a" = (/turf/Floors/Grass,/area)
"b" = (/turf/Walls/StoneWall,/area)
"c" = (/turf/Floors/Grass,/turf/Start,/area)
"d" = (/turf/Floors/Sand,/area)
"e" = (/turf/Floors/Sand,/turf/Traps/Quicksand,/area)
"f" = (/turf/Traps/Quicksand,/area)
"g" = (/obj/Swords/ExplorerSword,/turf/Floors/Grass,/area)
"h" = (/mob/NPC/Monster/Slime/RedSlime,/turf/Floors/Grass,/area)
"i" = (/mob/NPC/Monster/Slime/BlueSlime,/turf/Floors/Grass,/area)
"j" = (/obj/Daggers/TestDagger,/turf/Floors/Grass,/area)

(1,1,1) = {"
dddddddddddddddddddddddddddddddddddddddddddddddddd
dddddddddddddddddddddddddddddddddddddddddddddddddd
dddddddeddddddddddddddddddddddddddddfddddddddddddd
ddddddddddddddddddddddddddddddddddeddddddddddddfdd
dddddddddddddddddddddddddddddddddddddddddddddddddd
dddfdddddddddddddddddddddddddddddddddddddddddddddd
dddddddddddddddddddddddedddddddddddddddddddddddddd
dddddddddddddddddddddddddddddddddddddddddddddddddd
ddddddddddddddddeddddddddddddddddddddddddddddddddd
dddddddddddddddddddddddddddddddddddddfdddddddddddd
dddddddddddddddddddddddddddddddddddddddddddddddddd
ddddddddfddddddddddddddddddddddddddddddddddddddddd
dddddddddddddddddddddddddddddddddddddddddddddddddd
ddddddddddddddddddddaddddddddddddddddddddddddddddd
bbbbbbbbbbbbbbbbbbbaaadabbbbbbbbbbbbbbbbbbbbbbbbbb
aaaaaaaaaaaaaaaaabbbaaabbbaaaaaaaaaaaaaaaaaaaaaaaa
aaaaaaaaaaaaaaaaaaaaadaaaaaaaaaaaaaaaaaaaaaaaiaaaa
aaaaaaaaiaaaaaaaaaaaaaaaaaaaaaahaaaaaaaaaaaaaaaaaa
aaaaaaaaaaaaaaaaaaaaaadaaaaaaaaaaaaaaaaaaaaaaaaaaa
aaaaaaaaaaaaaahaaaaaaaaaaaaaaaaaaaaaaaaaaaaaaaaaaa
aahaaaaaaaaaaaaaaaaaaaaaaaaaaaaaaaaaaaaaaaaaaaaaaa
aaaaaaaaaaaaaaaaaaaaaaaaaaiaaaaaaaiaaaaaaaaaaahaaa
aaaaaaaaaaaaaaaaaaaaaaaaaaaaaaaaaaaaaaaaaaaaaaaaaa
aaaaaaaaaaaaaaaaaaaaaaaaaaaaaaaaaaaaaaaaaaaaaaaaaa
aaaaaaaaaaaaaiaaaaaaaaaaaaaaaaaaaaaaaaaaaaaaaaaaaa
aaaaaaaaahaaaaaaaaaaaaaaaaaaaaaaaaaaaaaaaaaaaaaaaa
aaaiaaaaaaaaaaaaaaaaaaaaaaaaaaaaaahaaaaaaaaaaaaaaa
aaaaaaaaaaaaaaaaaaaaaaaaaaaaaaaaaaaaaaaaaaiaaaaaaa
aaaaaaaaaaaaaaaaaaaaaaaaiaaaaaaaaaaaaaaaaaaaaaaaaa
aaaaaaaaaaaaaaaaaaaaaaaaaaaaaaaaaaaaaaaaaaaaaaaaaa
aaaaaaaaaiaaaaaaaaaaaaaaaaaaaaaaaaaaaaaaaaaaaaaaaa
aaaaaaaaaaaaaaahaaaaaaaaaaaaaaaaaaahaaaaaaaaaaaaaa
aaaaaaaaaaaaaaaaaaaaaaaaaaaaaaaaaaaaaaaaaaaaaaaaaa
aaaaaaaaaaaaaaaaaaaaaaahaaaaaaaaaaaaaaaaaaaaaaaaaa
aaaaaaaaaaaaaaaaaaaaaaaaaaaaaaaaaaaaaaaaaaaaaaaaaa
aaaaaaaaaaaaaaaaaaaaaaaaaaaaaaaaaaaaaaaaaaaaaaaaaa
bbbbbbbbbbbbbbbbaaaaaaaaaaaaaaaaaaaaaaaaaaaaaaaaaa
bgggjjjaaaaaaaaaaaaaaaaaaaaaaaaaaaaaaaiaaaaaaahaaa
baaaaaaaaaaaaaaaaaaaaaaaaaaaaaaaahaaaaaaaaaaaaaaaa
baaaaaaaaaaaaaabaaaaaaaaaaaaaaaaaaaaaaaaaaaaaaaaaa
baaaaaaaaaaaaaabaaaaaaaaaaiaaaaaaaaaaaaaaaaaaaaaaa
baaaaaaaaaaaaaabaaaaaaaaaaaaaaaaaaaaaaaaaaaaaaaaaa
baaaaaaaaaaaaaabaaaaaaaaaaaaaaaaaaaaaaaaaaaaaaaaaa
baaaaaaaaaaaaaabaaaaaaaaaaaaaaaaaaaaaaaaaaaaaaaaaa
baaaaaaaaaaaaaabaaaaaaaaaaaaaaaaaaaaaaaaaaaaaaaaia
baaaaaaaaaaaaaabaaaaaaaaiaaaaaaaaaaaahaaaaaaaaaaaa
baaaaaaaaaaaaaabaaaaaaaaaaaaaaaaaaaaaaaaaaaaaaaaaa
baaaaaaaaaaaaaabaaaaaaaaaaaaaaaaaaaaaaaaaaaaahaaaa
baaaaaaaaaaaaacbaaaaaahaaaaaaaaaiaaaaaaaaaaaaaaaaa
bbbbbbbbbbbbbbbbaaaaaaaaaaaaaaaaaaaaaaaaaaaaaaaaaa
"}
