"a" = (/turf/Floors/Grass,/area)
"b" = (/turf/Walls/StoneWall,/area)
"c" = (/turf/Floors/Grass,/turf/Start,/area)
"d" = (/turf/Floors/Sand,/area)
"e" = (/turf/Floors/Sand,/turf/Traps/Quicksand,/area)
"f" = (/turf/Traps/Quicksand,/area)
"g" = (/obj/Swords/ExplorerSword,/turf/Floors/Grass,/area)
"h" = (/mob/NPC/Monster/Slime/RedSlime,/turf/Floors/Grass,/area)
"i" = (/mob/NPC/Monster/Slime/BlueSlime,/turf/Floors/Grass,/area)
"j" = (/obj/Daggers/TestDagger,/turf/Floors/Grass,/area)
"k" = (/mob/NPC/Monster/Slime/GreenSlime,/turf/Floors/Grass,/area)
"l" = (/mob/NPC/Monster/TrainingDummy,/turf/Floors/Grass,/area)
"m" = (/mob/NPC/Monster/TrainingDummy/DummyE,/turf/Floors/Grass,/area)
"n" = (/mob/NPC/Monster/TrainingDummy/DummyW,/turf/Floors/Grass,/area)

(1,1,1) = {"
dddddddddddddddddddddddddddddddddddddddddddddddddd
dddddddddddddddddddddddddddddddddddddddddddddddddd
dddddddeddddddddddddddddddddddddddddfddddddddddddd
ddddddddddddddddddddddddddddddddddeddddddddddddfdd
dddddddddddddddddddddddddddddddddddddddddddddddddd
dddfdddddddddddddddddddddddddddddddddddddddddddddd
dddddddddddddddddddddddedddddddddddddddddddddddddd
dddddddddddddddddddddddddddddddddddddddddddddddddd
ddddddddddddddddeddddddddddddddddddddddddddddddddd
dddddddddddddddddddddddddddddddddddddfdddddddddddd
dddddddddddddddddddddddddddddddddddddddddddddddddd
ddddddddfddddddddddddddddddddddddddddddddddddddddd
dddddddddddddddddddddddddddddddddddddddddddddddddd
ddddddddddddddddddddaddddddddddddddddddddddddddddd
bbbbbbbbbbbbbbbbbbbaaadabbbbbbbbbbbbbbbbbbbbbbbbbb
aaaaaaaaaaaaaaaaabbbaaabbbaaaaaaaaaaaaaaaaaaaaaaaa
aaaaaaaaaaaaakaaaaaaadaaaaaaaaaaaaaaaaaaaaaaaiaaaa
aakaaaaaiaaaaaaaaaaaaaaaaaaaaaahaaaaaaaaaaaaaaaaaa
aaaaaaaaaaaaaaaaaaaaaadaakaaaaaaaaaaakaaaaaaaaakaa
aaaaaaaaaaaaaahaaaaaaaaaaaaaaaaaaaaaaaaaaaaaaaaaaa
aahaaaaaaaaaaaaaaaaaaaaaaaaaaaaaaaaaaaaaaaaaaaaaaa
aaaaaaakaaaaaaaaakaaaaaaaaiaaaaaaaiaaaakaaaaaahaaa
aaaaaaaaaaaaaaaaaaaalaaaaaaaaaaaaaaaaaaaaaaaaaaaaa
aaaaaaaaaaaaaaaaaaaalaaaaaaaaaaaaaaaaaaaaaaaaaaaaa
aaaaaaaaaaaaaiaaaaaaaaaaaaaaaaaaaaaaaaaaaaaaaaaaaa
aaaaaaaaahaaaaaaaaaaaaaaaaaaaaaaaaaaaaaaaaaaaaaaaa
aaaiaaaaaaaaaaaakaaaaaaaaaaaaaaaaahaaaaaaaaaaaaaaa
aaaaaaaaaaaaaaaaaaaaaaaaaaaakaaaaaaaaaaaaaiaaaaaaa
aaaaaaaaaaaaaaaaaaaaaaaaiaaaaaaaaaaaaaaaaaaaaaaaaa
aaaaaaaaaaaaaaaaaaaaaaaaaaaaaaaaaaaaaaaaaaaaaaaaaa
aaaaaaaaaiaaaaaaaaaaaaaaaaaaaaaaaaaaaaaaaaaaakaaaa
aaaaaaaaaaaaaaahaaaaaaaaaaaaaaaaaaahaaaaaaaaaaaaaa
aaaaaaaaaaaaaaaaaaaaaaaaaaaaaaaaaaaaaaaaaaaaaaaaaa
aaaaaaaaaaaaaaaaaaaaaaahaaaaakaaaaaaaaaaaaaaaaaaaa
aaaaaaaaaaaaaaaaaaaaaaaaaaaaaaaaaaaaaaaaaaaaaaaaaa
aaaaaaaaaaaaaaaaaaaaaaaaaaaaaaaaaaaaaaaaaakaaaaaaa
bbbbbbbbbbbbbbbbaaaaaakaaaaaaaaaaaaaaaaaaaaaaaaaaa
bgggjjjaaaaaaaaaaaaaaaaaaaaaaaaaaaaaaaiaaaaaaahaaa
baaaaaaaaaaaaaaaaaaaaaaaaaaaaaaaahaaaaaaaaaaaaaaaa
baaaaaaaaaaaaaabaaaaaaaaaaaaaaaaaaaaaaaaaaaaaaaaaa
baaaaaaaaaaaaaabaaaaaaaaaaiaaaaaaaaaaaaaaaaaaaaaaa
baaaaaaaaaaaaaabaaaaaaaaaaaaaaaaaaaaaaakaaaaaaaaaa
baaaaaaaaamaaanbaaaaaaaaaaaaaaaaaaaaaaaaaaaaaaaaaa
baaaaaaaaamaaanbaaaakaaaaaaaaaaaaaaaaaaaaaaaaaaaaa
baaaaaaaaamaaanbaaaaaaaaaaakaaaaaaaaaaaaaaaaaaaaia
baaaaaaaaaaaaaabaaaaaaaaiaaaaaaaaaaaahaaaaaaaaaaaa
baaaaaaaaaaaaaabaaaaaaaaaaaaaaaaaaaaaaaaakaaaaaaaa
baaaaaaaaaaaaaabaaaaaaaaaaaaaaaaaaaaaaaaaaaaahaaaa
baaaaaaaaaaaaacbaaaaaahaaaaaaaaaiaaaaaaaaaaaaaaaka
bbbbbbbbbbbbbbbbaaaaaaaaaaaaaaaaaaaaaaaaaaaaaaaaaa
"}
